2 2 2 2 2 2 2 2 2 2 2 2 2 2 2 2 2 2 2 2 2 2 2 2
2 r r 0 r r 0 0 0 0 0 0 0 0 s s 0 0 0 0 0 0 0 2
2 r r 0 r r 0 0 0 0 0 0 0 0 0 0 0 0 0 0 0 0 0 2
2 0 0 0 0 0 0 0 0 0 0 0 0 0 0 0 0 0 0 0 0 0 0 2
2 0 0 0 0 0 0 0 0 0 0 0 0 0 0 0 0 0 0 0 0 0 0 2
2 0 0 0 0 0 0 0 0 0 0 0 0 0 0 c3 c3 c3 c3 c3 c3 0 0 2
2 0 0 0 0 0 0 0 0 0 0 0 0 0 c2 t1 t1 t1 t1 t1 t1 c1 0 2
2 0 0 0 0 0 0 0 0 0 0 0 0 0 c2 t1 t1 t1 t1 t1 t1 c1 0 2
2 0 0 0 0 0 0 0 0 0 0 0 0 0 0 0 0 0 0 0 0 0 0 2
2 a a a a a a a a a 0 0 0 0 a a a a a a a a a 2
2 0 0 0 0 0 0 0 0 0 0 0 0 0 0 0 0 0 0 0 0 0 0 2
2 0 0 0 0 0 0 0 0 0 0 0 0 0 0 0 0 0 0 0 0 0 0 2
2 0 0 0 0 0 0 0 0 0 0 0 0 0 0 0 0 0 0 0 0 0 0 2
2 0 0 0 0 0 0 0 0 0 0 0 0 0 0 0 0 0 0 0 0 0 0 2
2 0 0 0 0 0 0 0 0 0 0 0 0 0 0 0 0 0 0 0 0 0 0 2
2 a a a a a a a a a 0 0 0 0 a a a a a a a a a 2
2 r r 0 0 0 0 0 0 0 0 0 0 0 0 0 0 0 t 0 0 r r 2
2 r r 0 0 0 0 0 0 0 0 0 0 0 0 0 0 0 0 0 0 r r 2
2 0 0 0 0 0 0 0 0 z 0 0 0 0 z 0 0 0 0 0 0 0 0 2
2 0 0 0 0 0 0 b b z 0 0 0 0 z 0 0 0 0 0 0 b b 2
2 c4 0 0 0 0 0 b b z 0 0 0 0 z 0 0 0 0 0 0 b b 2
2 t2 t2 0 0 0 0 b b z 0 0 0 0 z 0 0 0 t2 t2 0 b b 2
2 t2 t2 c4 0 0 0 b b z 0 0 0 0 z 0 0 0 t2 t2 c4 b b 2
2 2 2 2 2 2 2 2 2 2 2 2 2 2 2 2 2 2 2 2 2 2 2 2