2 2 2 2 2 2 2 2 2 2 2 2 2 
2 r r 0 0 t 0 0 0 C C 0 2 
2 r r 0 0 0 0 0 0 C C 0 2 
2 0 0 0 0 0 0 0 0 C C 0 2 
2 0 0 0 0 0 0 0 0 0 b b 2 
2 c4 0 0 0 0 0 0 0 0 b b 2 
2 t2 t2 0 0 0 0 0 0 0 b b 2
2 t2 t2 c4 0 0 0 0 0 0 b b 2
2 2 2 2 2 2 2 2 2 2 2 2 2 
