w w w w w w w w w w w w 
w n 0 0 0 S 0 0 0 0 0 w
w 0 0 s s s 0 c c c 0 w
w d 0 0 0 0 0 c c c 0 w
w d 0 0 0 0 0 0 0 0 0 w
w d 0 0 0 0 0 c c c 0 w
w d 0 0 0 0 0 c c c 0 w
w d 0 0 0 0 0 0 0 0 0 w
w w w w w 0 w w w w w w 